11111111111111111111111
10000001000000000010001
10000000111110000010001
10000000100010000001001
11111100000000000001001
10000000000000000000001
11111111111111111111111
