SO ./textures/wood.xpm
WE ./textures/eagle.xpm
EA ./textures/mossy.xpm
NO ./textures/colorstone.xpm

F 169,169,169
C 135                  ,              206                 ,235


        1111111111111111111111111
        1000000000110000000000001   111111
        1010000001110000000000001   100001
        1001000000000000000000001   100001
111111111011000001110000000000001   111111
110000000011000001110111111111111
11110111111111011100000010001
11110111111111011101010010001
110000001101010111000000100001
10000000000000001100000010001
10000000000000001101010000001
1100000111010101110101111000111
1111N111 1110101 101111010001
11111111 1111111 111111111111
                             
11111111111111111111111111111