EA ./textures/mossy.xpm
SO ./textures/wood.xpm
NO ./textures/colorstone.xpm
WE    ./textures/eagle.xpm

C                   255,255,255



F                    0,0,255

1111111111111111111111111111111
 1000000000000000000010000000001
11000000011100000000010000000001
10000000001000000000110000000001
11111111001111110000100000111111
10000000001000000000100000000011
11110000000001000000111000000001
11110000000001000000000000000001
11000001111111110000001000000001
10000010000000000000111000000001
10000010000N00110001000001100001
10000001110001000011100011000001
10000000010000000000000000000001
111111111 1111111111111111111111